coorte,corso_codice,corso_descrizione,studenti,genere_m,genere_f,p_genere_m,p_genere_f
2017/2018,0881,ARCHITETTURA,90,43,47,0.478,0.522
2017/2018,0884,CHIMICA INDUSTRIALE,79,52,27,0.658,0.342
2017/2018,0897,DIREZIONE AZIENDALE,117,76,41,0.65,0.35
2017/2018,0900,ECONOMIA E PROFESSIONE,62,39,23,0.629,0.371
2017/2018,0901,"FINANZA, INTERMEDIARI E MERCATI",99,73,26,0.737,0.263
2017/2018,0902,INNOVATION AND ORGANIZATION OF CULTURE AND THE ARTS,23,2,21,0.087,0.913
2017/2018,0905,ECONOMIA E COMMERCIO,90,34,56,0.378,0.622
2017/2018,0923,INGEGNERIA ELETTRONICA E TELECOMUNICAZIONI,112,97,15,0.866,0.134
2017/2018,0924,INGEGNERIA ENERGETICA,149,111,38,0.745,0.255
2017/2018,0925,INGEGNERIA GESTIONALE,250,158,92,0.632,0.368
2017/2018,0926,INGEGNERIA INFORMATICA,186,162,24,0.871,0.129
2017/2018,0927,INGEGNERIA MECCANICA,181,163,18,0.901,0.099
2017/2018,0930,INGEGNERIA CIVILE,97,66,31,0.68,0.32
2017/2018,0934,INGEGNERIA ELETTRONICA,57,42,15,0.737,0.263
2017/2018,0935,INGEGNERIA ENERGETICA,114,82,32,0.719,0.281
2017/2018,0936,INGEGNERIA GESTIONALE,228,137,91,0.601,0.399
2017/2018,0937,INGEGNERIA INFORMATICA,93,80,13,0.86,0.14
2017/2018,0938,INGEGNERIA MECCANICA,174,161,13,0.925,0.075
2017/2018,0940,INGEGNERIA EDILE - ARCHITETTURA,74,38,36,0.514,0.486
2017/2018,0946,INGEGNERIA BIOMEDICA,125,66,59,0.528,0.472
2017/2018,0949,INGEGNERIA MECCANICA,113,106,7,0.938,0.062
2017/2018,0956,"DAMS - DISCIPLINE DELLE ARTI, DELLA MUSICA  E DELLO SPETTACOLO",568,229,339,0.403,0.597
2017/2018,0962,STORIA,212,154,58,0.726,0.274
2017/2018,0964,ANTROPOLOGIA CULTURALE ED ETNOLOGIA,123,35,88,0.285,0.715
2017/2018,0966,"CINEMA, TELEVISIONE E PRODUZIONE MULTIMEDIALE",128,56,72,0.438,0.563
2017/2018,0970,"FILOLOGIA, LETTERATURA E TRADIZIONE CLASSICA",79,26,53,0.329,0.671
2017/2018,0971,GEOGRAFIA E PROCESSI TERRITORIALI,26,15,11,0.577,0.423
2017/2018,0977,ARTI VISIVE,259,39,220,0.151,0.849
2017/2018,0979,LINGUE E LETTERATURE STRANIERE,385,86,299,0.223,0.777
2017/2018,0980,"LINGUE, MERCATI E CULTURE DELL'ASIA",104,23,81,0.221,0.779
2017/2018,0981,"LETTERATURE MODERNE, COMPARATE E POSTCOLONIALI",158,26,132,0.165,0.835
2017/2018,0983,LINGUA E CULTURA ITALIANE PER STRANIERI,169,29,140,0.172,0.828
2017/2018,0989,NEUROSCIENZE E RIABILITAZIONE NEUROPSICOLOGICA,42,11,31,0.262,0.738
2017/2018,0990,PSICOLOGIA CLINICA,88,14,74,0.159,0.841
2017/2018,0991,PSICOLOGIA COGNITIVA APPLICATA,39,16,23,0.41,0.59
2017/2018,0993,PSICOLOGIA SCOLASTICA E DI COMUNITA',34,3,31,0.088,0.912
2017/2018,8004,ASTRONOMIA,69,48,21,0.696,0.304
2017/2018,8005,BIOTECNOLOGIE,85,35,50,0.412,0.588
2017/2018,8006,CHIMICA E CHIMICA DEI MATERIALI,111,48,63,0.432,0.568
2017/2018,8007,FISICA,137,108,29,0.788,0.212
2017/2018,8009,INFORMATICA,118,105,13,0.89,0.11
2017/2018,8010,MATEMATICA,226,116,110,0.513,0.487
2017/2018,8011,SCIENZE AMBIENTALI,66,34,32,0.515,0.485
2017/2018,8012,SCIENZE BIOLOGICHE,149,37,112,0.248,0.752
2017/2018,8014,INFORMATICA PER IL MANAGEMENT,96,69,27,0.719,0.281
2017/2018,8015,SCIENZE GEOLOGICHE,31,19,12,0.613,0.387
2017/2018,8016,SCIENZE NATURALI,57,27,30,0.474,0.526
2017/2018,8018,ASTROFISICA E COSMOLOGIA,32,20,12,0.625,0.375
2017/2018,8020,BIOINFORMATICS,19,10,9,0.526,0.474
2017/2018,8021,BIOLOGIA MOLECOLARE E CELLULARE,41,13,28,0.317,0.683
2017/2018,8025,FISICA,94,75,19,0.798,0.202
2017/2018,8026,FOTOCHIMICA E MATERIALI MOLECOLARI,31,20,11,0.645,0.355
2017/2018,8027,GEOLOGIA E TERRITORIO,36,19,17,0.528,0.472
2017/2018,8028,INFORMATICA,65,52,13,0.8,0.2
2017/2018,8037,SCIENZE E TECNICHE DELL'ATTIVITA' SPORTIVA,57,51,6,0.895,0.105
2017/2018,8038,"ECONOMIA, MERCATI E ISTITUZIONI",191,122,69,0.639,0.361
2017/2018,8040,SERVIZIO SOCIALE,87,11,76,0.126,0.874
2017/2018,8048,SCIENZE INTERNAZIONALI E DIPLOMATICHE,366,134,232,0.366,0.634
2017/2018,8049,INTERDISCIPLINARY RESEARCH AND STUDIES ON EASTERN EUROPE,37,12,25,0.324,0.676
2017/2018,8051,MASS MEDIA E POLITICA,36,19,17,0.528,0.472
2017/2018,8059,MEDIAZIONE LINGUISTICA INTERCULTURALE,160,27,133,0.169,0.831
2017/2018,8060,INTERPRETAZIONE,31,4,27,0.129,0.871
2017/2018,8182,DESIGN DEL PRODOTTO INDUSTRIALE,80,40,40,0.5,0.5
2017/2018,8198,INGEGNERIA BIOMEDICA,48,19,29,0.396,0.604
2017/2018,8204,ODONTOIATRIA E PROTESI DENTARIA,20,7,13,0.35,0.65
2017/2018,8208,MATEMATICA,67,31,36,0.463,0.537
2017/2018,8209,SCIENZE E GESTIONE DELLA NATURA,39,14,25,0.359,0.641
2017/2018,8406,MANAGEMENT E MARKETING,139,96,43,0.691,0.309
2017/2018,8408,ECONOMICS,36,23,13,0.639,0.361
2017/2018,8412,CHIMICA E TECNOLOGIA FARMACEUTICHE,100,31,69,0.31,0.69
2017/2018,8415,MEDICINA E CHIRURGIA,229,98,131,0.428,0.572
2017/2018,8418,ANALISI E GESTIONE DELL'AMBIENTE,40,19,21,0.475,0.525
2017/2018,8419,BIODIVERSITA' ED EVOLUZIONE,38,10,28,0.263,0.737
2017/2018,8420,ECONOMIA E POLITICA ECONOMICA,64,41,23,0.641,0.359
2017/2018,8470,DIETISTICA (ABILITANTE ALLA PROFESSIONE SANITARIA DI DIETISTA),7,4,3,0.571,0.429
2017/2018,8473,INFERMIERISTICA (ABILITANTE ALLA PROFESSIONE SANITARIA DI INFERMIERE),205,37,168,0.18,0.82
2017/2018,8474,INFERMIERISTICA (ABILITANTE ALLA PROFESSIONE SANITARIA DI INFERMIERE),110,20,90,0.182,0.818
2017/2018,8475,INFERMIERISTICA (ABILITANTE ALLA PROFESSIONE SANITARIA DI INFERMIERE),167,34,133,0.204,0.796
2017/2018,8476,FISIOTERAPIA (ABILITANTE ALLA PROFESSIONE SANITARIA DI FISIOTERAPISTA),22,6,16,0.273,0.727
2017/2018,8477,EDUCAZIONE PROFESSIONALE (ABILITANTE ALLA PROFESSIONE SANITARIA DI EDUCATORE PROFESSIONALE),29,8,21,0.276,0.724
2017/2018,8478,LOGOPEDIA (ABILITANTE ALLA PROFESSIONE SANITARIA DI LOGOPEDISTA),11,0,11,0,1
2017/2018,8479,PODOLOGIA (ABILITANTE ALLA PROFESSIONE SANITARIA DI PODOLOGO),8,5,3,0.625,0.375
2017/2018,8481,IGIENE DENTALE (ABILITANTE ALLA PROFESSIONE SANITARIA DI IGIENISTA DENTALE),14,2,12,0.143,0.857
2017/2018,8482,TECNICHE DI NEUROFISIOPATOLOGIA (ABILITANTE ALLA PROFESSIONE SANITARIA DI TECNICO DI NEUROFISIOPATOLOGIA),5,0,5,0,1
2017/2018,8483,TECNICHE ORTOPEDICHE (ABILITANTE ALLA PROFESSIONE SANITARIA DI TECNICO ORTOPEDICO),8,2,6,0.25,0.75
2017/2018,8484,TECNICHE DI LABORATORIO BIOMEDICO (ABILITANTE ALLA PROFESSIONE SANITARIA DI TECNICO DI LABORATORIO BIOMEDICO),8,4,4,0.5,0.5
2017/2018,8485,"TECNICHE DI RADIOLOGIA MEDICA, PER IMMAGINI E RADIOTERAPIA (ABILITANTE ALLA PROFESSIONE SANITARIA DI TECNICO DI RADIOLOGIA MEDICA)",10,6,4,0.6,0.4
2017/2018,8486,"TECNICHE DI RADIOLOGIA MEDICA, PER IMMAGINI E RADIOTERAPIA (ABILITANTE ALLA PROFESSIONE SANITARIA DI TECNICO DI RADIOLOGIA MEDICA)",6,2,4,0.333,0.667
2017/2018,8487,TECNICHE DELLA PREVENZIONE NELL'AMBIENTE E NEI LUOGHI DI LAVORO (ABILITANTE  ALLA PROFESSIONE SANITARIA DI TECNICO DELLA PREVENZIONE NELL'AMBIENTE E NEI LUOGHI DI LAVORO),16,7,9,0.438,0.563
2017/2018,8488,SCIENZE INFERMIERISTICHE E OSTETRICHE,23,4,19,0.174,0.826
2017/2018,8491,SCIENZE CRIMINOLOGICHE PER L'INVESTIGAZIONE E LA SICUREZZA,142,28,114,0.197,0.803
2017/2018,8493,"ANTROPOLOGIA, RELIGIONI, CIVILTA' ORIENTALI",266,71,195,0.267,0.733
2017/2018,8495,SOCIOLOGIA,151,48,103,0.318,0.682
2017/2018,8512,SCIENZE DELLE ATTIVITA' MOTORIE E SPORTIVE,176,133,43,0.756,0.244
2017/2018,8513,CHIMICA INDUSTRIALE,98,68,30,0.694,0.306
2017/2018,8514,CHIMICA E TECNOLOGIE PER L'AMBIENTE E PER I MATERIALI,29,18,11,0.621,0.379
2017/2018,8515,CHIMICA E TECNOLOGIE PER L'AMBIENTE E PER I MATERIALI,32,19,13,0.594,0.406
2017/2018,8518,SCIENZE FARMACEUTICHE APPLICATE,49,9,40,0.184,0.816
2017/2018,8519,BIOTECNOLOGIE FARMACEUTICHE,38,11,27,0.289,0.711
2017/2018,8521,SICUREZZA E QUALITA' DELLE PRODUZIONI ANIMALI,48,22,26,0.458,0.542
2017/2018,8522,BIOTECNOLOGIE ANIMALI,24,4,20,0.167,0.833
2017/2018,8523,VERDE ORNAMENTALE E TUTELA DEL PAESAGGIO,33,13,20,0.394,0.606
2017/2018,8524,TECNOLOGIE AGRARIE,122,97,25,0.795,0.205
2017/2018,8525,SCIENZE DEL TERRITORIO E DELL'AMBIENTE AGRO-FORESTALE,39,27,12,0.692,0.308
2017/2018,8526,ECONOMIA E MARKETING NEL SISTEMA AGRO-INDUSTRIALE,68,46,22,0.676,0.324
2017/2018,8527,VITICOLTURA ED ENOLOGIA,54,33,21,0.611,0.389
2017/2018,8528,TECNOLOGIE ALIMENTARI,84,46,38,0.548,0.452
2017/2018,8531,SCIENZE E TECNOLOGIE ALIMENTARI,64,25,39,0.391,0.609
2017/2018,8532,"PROGETTAZIONE E GESTIONE DEGLI ECOSISTEMI AGRO-TERRITORIALI, FORESTALI E DEL PAESAGGIO",28,18,10,0.643,0.357
2017/2018,8537,SCIENCE FOR THE CONSERVATION - RESTORATION OF CULTURAL HERITAGE,24,9,15,0.375,0.625
2017/2018,8540,SCIENZE DELLA FORMAZIONE PRIMARIA,183,14,169,0.077,0.923
2017/2018,8609,TOURISM ECONOMICS AND MANAGEMENT / ECONOMIA E MANAGEMENT DEL TURISMO,58,22,36,0.379,0.621
2017/2018,8610,INGEGNERIA DELL'ENERGIA ELETTRICA,96,82,14,0.854,0.146
2017/2018,8611,INGEGNERIA DELL'ENERGIA ELETTRICA,67,55,12,0.821,0.179
2017/2018,8614,INGEGNERIA E SCIENZE INFORMATICHE,55,48,7,0.873,0.127
2017/2018,8615,INGEGNERIA E SCIENZE INFORMATICHE,184,156,28,0.848,0.152
2017/2018,8616,CONSERVAZIONE E RESTAURO DEI BENI CULTURALI (ABILITANTE AI SENSI DEL D. LGS N. 42/2004),9,0,9,0,1
2017/2018,8617,MEDICINA VETERINARIA,52,20,32,0.385,0.615
2017/2018,8626,FISICA DEL SISTEMA TERRA,26,13,13,0.5,0.5
2017/2018,8766,SCIENZE DELLE ATTIVITA' MOTORIE E SPORTIVE,96,66,30,0.688,0.313
2017/2018,8767,INGEGNERIA ELETTRONICA PER L'ENERGIA E L'INFORMAZIONE,56,51,5,0.911,0.089
2017/2018,8769,AEROSPACE ENGINEERING / INGEGNERIA AEROSPAZIALE,42,37,5,0.881,0.119
2017/2018,8770,INGEGNERIA ELETTRONICA E TELECOMUNICAZIONI PER L?ENERGIA,26,23,3,0.885,0.115
2017/2018,8771,INGEGNERIA MECCANICA,37,34,3,0.919,0.081
2017/2018,8772,CULTURE E TECNICHE DELLA MODA,189,23,166,0.122,0.878
2017/2018,8773,SCIENZE FILOSOFICHE,123,63,60,0.512,0.488
2017/2018,8774,SCIENZE E TECNICHE PSICOLOGICHE,220,59,161,0.268,0.732
2017/2018,8775,EDUCATORE NEI SERVIZI PER L'INFANZIA,228,7,221,0.031,0.969
2017/2018,8776,EDUCATORE SOCIALE E CULTURALE,203,38,165,0.187,0.813
2017/2018,8777,EDUCATORE SOCIALE E CULTURALE,112,22,90,0.196,0.804
2017/2018,8780,SCIENZE DELL?EDUCAZIONE PERMANENTE E DELLA FORMAZIONE CONTINUA,38,6,32,0.158,0.842
2017/2018,8782,RELAZIONI INTERNAZIONALI,83,40,43,0.482,0.518
2017/2018,8783,SCIENZE INTERNAZIONALI E DIPLOMATICHE,116,47,69,0.405,0.595
2017/2018,8784,"POLITICA, AMMINISTRAZIONE E ORGANIZZAZIONE",70,38,32,0.543,0.457
2017/2018,8786,SOCIOLOGIA E SERVIZIO SOCIALE,100,22,78,0.22,0.78
2017/2018,8829,INGEGNERIA DEI PROCESSI E DEI SISTEMI EDILIZI,50,23,27,0.46,0.54
2017/2018,8834,ACQUACOLTURA E IGIENE DELLE PRODUZIONI ITTICHE,43,18,25,0.419,0.581
2017/2018,8835,ECONOMICS AND FINANCE /ECONOMIA E FINANZA,100,61,39,0.61,0.39
2017/2018,8837,DISCIPLINE DELLA MUSICA E DEL TEATRO,64,18,46,0.281,0.719
2017/2018,8838,SCIENZE DEL LIBRO E DEL DOCUMENTO,26,3,23,0.115,0.885
2017/2018,8839,RESOURCE ECONOMICS AND SUSTAINABLE DEVELOPMENT / ECONOMIA DELLE RISORSE E DELLO SVILUPPO SOSTENIBILE,29,19,10,0.655,0.345
2017/2018,8840,COMUNICAZIONE PUBBLICA E D'IMPRESA,117,38,79,0.325,0.675
2017/2018,8842,AMMINISTRAZIONE E GESTIONE D'IMPRESA,104,47,57,0.452,0.548
2017/2018,8843,MANAGEMENT DELL?ECONOMIA SOCIALE,41,18,23,0.439,0.561
2017/2018,8845,SCIENZE STORICHE E ORIENTALISTICHE,240,151,89,0.629,0.371
2017/2018,8847,ECONOMIA DEL TURISMO,165,58,107,0.352,0.648
2017/2018,8848,ECONOMIA DELL'IMPRESA,155,77,78,0.497,0.503
2017/2018,8849,BENI CULTURALI,179,40,139,0.223,0.777
2017/2018,8850,LETTERE,617,158,459,0.256,0.744
2017/2018,8853,"SCIENZE POLITICHE, SOCIALI E INTERNAZIONALI",454,180,274,0.396,0.604
2017/2018,8854,QUANTITATIVE FINANCE,50,38,12,0.76,0.24
2017/2018,8855,ARCHEOLOGIA E CULTURE DEL MONDO ANTICO,88,32,56,0.364,0.636
2017/2018,8856,CHIMICA,55,36,19,0.655,0.345
2017/2018,8857,BIOLOGIA MARINA,39,6,33,0.154,0.846
2017/2018,8859,BIOTECNOLOGIE MEDICHE,32,8,24,0.25,0.75
2017/2018,8871,ECONOMIA AZIENDALE,180,115,65,0.639,0.361
2017/2018,8872,"FINANZA, ASSICURAZIONI E IMPRESA",56,41,15,0.732,0.268
2017/2018,8873,SCIENZE STATISTICHE,114,66,48,0.579,0.421
2017/2018,8874,"LANGUAGE, SOCIETY AND COMMUNICATION / LINGUA, SOCIETA E COMUNICAZIONE",182,23,159,0.126,0.874
2017/2018,8876,"STATISTICA, ECONOMIA E IMPRESA",122,53,69,0.434,0.566
2017/2018,8877,"SCIENZE STATISTICHE, FINANZIARIE E ATTUARIALI",42,25,17,0.595,0.405
2017/2018,8878,SCIENZE DELLE PROFESSIONI SANITARIE DELLA PREVENZIONE,15,6,9,0.4,0.6
2017/2018,8879,ASSISTENZA SANITARIA (ABILITANTE ALLA PROFESSIONE SANITARIA DI ASSISTENTE SANITARIO),10,3,7,0.3,0.7
2017/2018,8880,HEALTH ECONOMICS AND MANAGEMENT / ECONOMIA SANITARIA E MANAGEMENT,15,6,9,0.4,0.6
2017/2018,8882,PRODUZIONI ANIMALI,77,30,47,0.39,0.61
2017/2018,8883,INTERNATIONAL HORTICULTURAL SCIENCE / ORTOFRUTTICOLTURA INTERNAZIONALE,35,20,15,0.571,0.429
2017/2018,8885,SCIENZE DELLA COMUNICAZIONE,533,182,351,0.341,0.659
2017/2018,8886,SEMIOTICA,85,37,48,0.435,0.565
2017/2018,8887,INGEGNERIA CHIMICA E BIOCHIMICA,144,77,67,0.535,0.465
2017/2018,8888,INGEGNERIA CIVILE,92,66,26,0.717,0.283
2017/2018,8890,SVILUPPO E COOPERAZIONE INTERNAZIONALE,111,40,71,0.36,0.64
2017/2018,8891,AUTOMATION ENGINEERING / INGEGNERIA DELL?AUTOMAZIONE,90,82,8,0.911,0.089
2017/2018,8894,INGEGNERIA PER L'AMBIENTE E IL TERRITORIO,102,63,39,0.618,0.382
2017/2018,8895,CIVIL ENGINEERING,57,40,17,0.702,0.298
2017/2018,8896,INGEGNERIA CHIMICA E DI PROCESSO,93,58,35,0.624,0.376
2017/2018,8965,BUSINESS AND ECONOMICS/ECONOMIA E GESTIONE DI IMPRESA,138,58,80,0.42,0.58
2017/2018,9021,ADVANCED DESIGN,21,9,12,0.429,0.571
2017/2018,9022,FASHION CULTURE AND MANAGEMENT,32,5,27,0.156,0.844
2017/2018,9174,SPECIALIZED TRANSLATION,60,11,49,0.183,0.817
2017/2018,9198,INGEGNERIA PER L'AMBIENTE E IL TERRITORIO,93,60,33,0.645,0.355
2017/2018,9199,INGEGNERIA EDILE,32,18,14,0.563,0.438
2017/2018,9200,SVILUPPO LOCALE E GLOBALE,61,19,42,0.311,0.689
2017/2018,9201,OSTETRICIA (ABILITANTE ALLA PROFESSIONE SANITARIA DI OSTETRICA/O),15,0,15,0,1
2017/2018,9202,ECONOMIA E COMMERCIO,351,177,174,0.504,0.496
2017/2018,9203,ECONOMIA E MANAGEMENT,106,52,54,0.491,0.509
2017/2018,9205,TELECOMMUNICATIONS ENGINEERING,35,30,5,0.857,0.143
2017/2018,9206,PEDAGOGIA,114,10,104,0.088,0.912
2017/2018,9210,MEDICINE AND SURGERY,48,25,23,0.521,0.479
2017/2018,9211,GENOMICS,33,10,23,0.303,0.697
2017/2018,9212,BIOLOGIA DELLA SALUTE,50,11,39,0.22,0.78
2017/2018,9213,BIOTECNOLOGIE MOLECOLARI E INDUSTRIALI,30,21,9,0.7,0.3
2017/2018,9214,MANAGEMENT DELLE ATTIVITA MOTORIE E SPORTIVE,56,44,12,0.786,0.214
2017/2018,9215,SCIENZE E TECNICHE DELL'ATTIVITA' MOTORIA PREVENTIVA E ADATTATA,62,34,28,0.548,0.452
2017/2018,9216,FILOSOFIA,255,137,118,0.537,0.463
2017/2018,9217,INGEGNERIA DELL?AUTOMAZIONE,146,130,16,0.89,0.11
2017/2018,9218,"BENI ARCHEOLOGICI, ARTISTICI E DEL PAESAGGIO: STORIA, TUTELA E VALORIZZAZIONE",70,17,53,0.243,0.757
2017/2018,9219,FARMACIA,150,38,112,0.253,0.747
2017/2018,9220,"ITALIANISTICA, CULTURE LETTERARIE EUROPEE, SCIENZE LINGUISTICHE",392,114,278,0.291,0.709
2017/2018,9221,ECONOMIA E DIRITTO,70,36,34,0.514,0.486
2017/2018,9222,STATISTICAL SCIENCES,56,24,32,0.429,0.571
2017/2018,9223,FARMACIA,77,17,60,0.221,0.779
2017/2018,9224,DIGITAL HUMANITIES AND DIGITAL KNOWLEDGE,17,6,11,0.353,0.647
2017/2018,9227,"WELLNESS CULTURE: SPORT, HEALTH AND TOURISM",7,5,2,0.714,0.286
2017/2018,9228,PROGETTAZIONE E GESTIONE DELL'INTERVENTO EDUCATIVO NEL DISAGIO SOCIALE,110,7,103,0.064,0.936
2017/2018,9229,PROGETTAZIONE E GESTIONE DELL'INTERVENTO EDUCATIVO NEL DISAGIO SOCIALE,24,0,24,0,1
2017/2018,9230,CONSULENTE DEL LAVORO E DELLE RELAZIONI AZIENDALI,217,79,138,0.364,0.636
2017/2018,9231,GIURISTA PER LE IMPRESE E PER LA PUBBLICA AMMINISTRAZIONE,97,28,69,0.289,0.711
2017/2018,9232,GIURISPRUDENZA,995,360,635,0.362,0.638
2017/2018,9233,GIURISPRUDENZA,65,28,37,0.431,0.569
2017/2018,9234,INGEGNERIA AEROSPAZIALE,110,89,21,0.809,0.191
2017/2018,9235,SCIENZE E TECNOLOGIE AGRARIE,165,112,53,0.679,0.321
2017/2018,9236,"WORK, ORGANIZATIONAL AND PERSONNEL PSYCHOLOGY",10,3,7,0.3,0.7
2017/2018,9237,INTERNATIONAL COOPERATION ON HUMAN RIGHTS AND INTERCULTURAL HERITAGE,43,9,34,0.209,0.791
2017/2018,9238,ADVANCED AUTOMOTIVE ELECTRONIC  ENGINEERING,11,11,0,1,0
2017/2018,9239,ADVANCED AUTOMOTIVE ENGINEERING,10,9,1,0.9,0.1
2016/2017,0659,GIURISPRUDENZA,990,357,633,0.361,0.639
2016/2017,0660,GIURISPRUDENZA,63,22,41,0.349,0.651
2016/2017,0881,ARCHITETTURA,89,28,61,0.315,0.685
2016/2017,0884,CHIMICA INDUSTRIALE,81,54,27,0.667,0.333
2016/2017,0897,DIREZIONE AZIENDALE,117,65,52,0.556,0.444
2016/2017,0899,ECONOMIA E DIRITTO,57,36,21,0.632,0.368
2016/2017,0900,ECONOMIA E PROFESSIONE,61,44,17,0.721,0.279
2016/2017,0901,"FINANZA, INTERMEDIARI E MERCATI",95,71,24,0.747,0.253
2016/2017,0902,INNOVATION AND ORGANIZATION OF CULTURE AND THE ARTS,31,8,23,0.258,0.742
2016/2017,0905,ECONOMIA E COMMERCIO,89,29,60,0.326,0.674
2016/2017,0915,CONSULENTE DEL LAVORO E DELLE RELAZIONI AZIENDALI,188,64,124,0.34,0.66
2016/2017,0916,GIURISTA D'IMPRESA E DELLE AMMINISTRAZIONI PUBBLICHE,97,33,64,0.34,0.66
2016/2017,0920,INGEGNERIA DELL'AUTOMAZIONE,145,128,17,0.883,0.117
2016/2017,0923,INGEGNERIA ELETTRONICA E TELECOMUNICAZIONI,85,70,15,0.824,0.176
2016/2017,0924,INGEGNERIA ENERGETICA,167,137,30,0.82,0.18
2016/2017,0925,INGEGNERIA GESTIONALE,258,178,80,0.69,0.31
2016/2017,0926,INGEGNERIA INFORMATICA,177,163,14,0.921,0.079
2016/2017,0927,INGEGNERIA MECCANICA,182,161,21,0.885,0.115
2016/2017,0930,INGEGNERIA CIVILE,166,116,50,0.699,0.301
2016/2017,0934,INGEGNERIA ELETTRONICA,57,46,11,0.807,0.193
2016/2017,0935,INGEGNERIA ENERGETICA,99,74,25,0.747,0.253
2016/2017,0936,INGEGNERIA GESTIONALE,145,87,58,0.6,0.4
2016/2017,0937,INGEGNERIA INFORMATICA,90,84,6,0.933,0.067
2016/2017,0938,INGEGNERIA MECCANICA,171,156,15,0.912,0.088
2016/2017,0940,INGEGNERIA EDILE - ARCHITETTURA,78,36,42,0.462,0.538
2016/2017,0946,INGEGNERIA BIOMEDICA,138,70,68,0.507,0.493
2016/2017,0949,INGEGNERIA MECCANICA,102,97,5,0.951,0.049
2016/2017,0956,"DAMS - DISCIPLINE DELLE ARTI, DELLA MUSICA  E DELLO SPETTACOLO",649,268,381,0.413,0.587
2016/2017,0957,FILOSOFIA,278,148,130,0.532,0.468
2016/2017,0962,STORIA,223,160,63,0.717,0.283
2016/2017,0964,ANTROPOLOGIA CULTURALE ED ETNOLOGIA,100,39,61,0.39,0.61
2016/2017,0966,"CINEMA, TELEVISIONE E PRODUZIONE MULTIMEDIALE",134,60,74,0.448,0.552
2016/2017,0970,"FILOLOGIA, LETTERATURA E TRADIZIONE CLASSICA",82,24,58,0.293,0.707
2016/2017,0971,GEOGRAFIA E PROCESSI TERRITORIALI,22,12,10,0.545,0.455
2016/2017,0973,"ITALIANISTICA, CULTURE LETTERARIE EUROPEE, SCIENZE LINGUISTICHE",339,95,244,0.28,0.72
2016/2017,0977,ARTI VISIVE,226,41,185,0.181,0.819
2016/2017,0979,LINGUE E LETTERATURE STRANIERE,390,85,305,0.218,0.782
2016/2017,0980,"LINGUE, MERCATI E CULTURE DELL'ASIA",102,25,77,0.245,0.755
2016/2017,0981,"LETTERATURE MODERNE, COMPARATE E POSTCOLONIALI",122,18,104,0.148,0.852
2016/2017,0983,LINGUA E CULTURA ITALIANE PER STRANIERI,138,22,116,0.159,0.841
2016/2017,0989,NEUROSCIENZE E RIABILITAZIONE NEUROPSICOLOGICA,40,7,33,0.175,0.825
2016/2017,0990,PSICOLOGIA CLINICA,92,17,75,0.185,0.815
2016/2017,0991,PSICOLOGIA COGNITIVA APPLICATA,44,11,33,0.25,0.75
2016/2017,0992,PSICOLOGIA DELLE ORGANIZZAZIONI E DEI SERVIZI,35,11,24,0.314,0.686
2016/2017,0993,PSICOLOGIA SCOLASTICA E DI COMUNITA',35,4,31,0.114,0.886
2016/2017,8004,ASTRONOMIA,68,48,20,0.706,0.294
2016/2017,8005,BIOTECNOLOGIE,89,40,49,0.449,0.551
2016/2017,8006,CHIMICA E CHIMICA DEI MATERIALI,117,71,46,0.607,0.393
2016/2017,8007,FISICA,142,104,38,0.732,0.268
2016/2017,8009,INFORMATICA,123,106,17,0.862,0.138
2016/2017,8010,MATEMATICA,186,93,93,0.5,0.5
2016/2017,8011,SCIENZE AMBIENTALI,83,31,52,0.373,0.627
2016/2017,8012,SCIENZE BIOLOGICHE,169,62,107,0.367,0.633
2016/2017,8014,INFORMATICA PER IL MANAGEMENT,75,56,19,0.747,0.253
2016/2017,8015,SCIENZE GEOLOGICHE,42,22,20,0.524,0.476
2016/2017,8016,SCIENZE NATURALI,61,33,28,0.541,0.459
2016/2017,8018,ASTROFISICA E COSMOLOGIA,25,13,12,0.52,0.48
2016/2017,8020,BIOINFORMATICS,21,13,8,0.619,0.381
2016/2017,8021,BIOLOGIA MOLECOLARE E CELLULARE,29,10,19,0.345,0.655
2016/2017,8022,BIOTECNOLOGIE MOLECOLARI E INDUSTRIALI,30,14,16,0.467,0.533
2016/2017,8023,BIOLOGIA DELLA SALUTE,62,9,53,0.145,0.855
2016/2017,8025,FISICA,96,71,25,0.74,0.26
2016/2017,8026,FOTOCHIMICA E MATERIALI MOLECOLARI,38,17,21,0.447,0.553
2016/2017,8027,GEOLOGIA E TERRITORIO,47,32,15,0.681,0.319
2016/2017,8028,INFORMATICA,47,44,3,0.936,0.064
2016/2017,8036,SCIENZE E TECNICHE DELL'ATTIVITA' MOTORIA PREVENTIVA E ADATTATA,79,37,42,0.468,0.532
2016/2017,8037,SCIENZE E TECNICHE DELL'ATTIVITA' SPORTIVA,57,46,11,0.807,0.193
2016/2017,8038,"ECONOMIA, MERCATI E ISTITUZIONI",195,127,68,0.651,0.349
2016/2017,8040,SERVIZIO SOCIALE,74,7,67,0.095,0.905
2016/2017,8048,SCIENZE INTERNAZIONALI E DIPLOMATICHE,474,151,323,0.319,0.681
2016/2017,8049,INTERDISCIPLINARY RESEARCH AND STUDIES ON EASTERN EUROPE,40,15,25,0.375,0.625
2016/2017,8051,MASS MEDIA E POLITICA,39,17,22,0.436,0.564
2016/2017,8059,MEDIAZIONE LINGUISTICA INTERCULTURALE,151,24,127,0.159,0.841
2016/2017,8060,INTERPRETAZIONE,30,3,27,0.1,0.9
2016/2017,8182,DESIGN DEL PRODOTTO INDUSTRIALE,74,34,40,0.459,0.541
2016/2017,8198,INGEGNERIA BIOMEDICA,57,22,35,0.386,0.614
2016/2017,8204,ODONTOIATRIA E PROTESI DENTARIA,24,14,10,0.583,0.417
2016/2017,8208,MATEMATICA,80,26,54,0.325,0.675
2016/2017,8209,SCIENZE E GESTIONE DELLA NATURA,27,14,13,0.519,0.481
2016/2017,8210,MANAGEMENT DELLE ATTIVITA' MOTORIE E SPORTIVE,32,23,9,0.719,0.281
2016/2017,8263,INGEGNERIA AEROSPAZIALE,112,89,23,0.795,0.205
2016/2017,8406,MANAGEMENT E MARKETING,143,97,46,0.678,0.322
2016/2017,8408,ECONOMICS,34,22,12,0.647,0.353
2016/2017,8412,CHIMICA E TECNOLOGIA FARMACEUTICHE,108,35,73,0.324,0.676
2016/2017,8413,FARMACIA,155,45,110,0.29,0.71
2016/2017,8414,FARMACIA,57,9,48,0.158,0.842
2016/2017,8415,MEDICINA E CHIRURGIA,292,151,141,0.517,0.483
2016/2017,8418,ANALISI E GESTIONE DELL'AMBIENTE,34,14,20,0.412,0.588
2016/2017,8419,BIODIVERSITA' ED EVOLUZIONE,46,21,25,0.457,0.543
2016/2017,8420,ECONOMIA E POLITICA ECONOMICA,81,48,33,0.593,0.407
2016/2017,8470,DIETISTICA (ABILITANTE ALLA PROFESSIONE SANITARIA DI DIETISTA),7,0,7,0,1
2016/2017,8473,INFERMIERISTICA (ABILITANTE ALLA PROFESSIONE SANITARIA DI INFERMIERE),201,45,156,0.224,0.776
2016/2017,8474,INFERMIERISTICA (ABILITANTE ALLA PROFESSIONE SANITARIA DI INFERMIERE),107,20,87,0.187,0.813
2016/2017,8475,INFERMIERISTICA (ABILITANTE ALLA PROFESSIONE SANITARIA DI INFERMIERE),173,36,137,0.208,0.792
2016/2017,8476,FISIOTERAPIA (ABILITANTE ALLA PROFESSIONE SANITARIA DI FISIOTERAPISTA),30,14,16,0.467,0.533
2016/2017,8477,EDUCAZIONE PROFESSIONALE (ABILITANTE ALLA PROFESSIONE SANITARIA DI EDUCATORE PROFESSIONALE),24,4,20,0.167,0.833
2016/2017,8478,LOGOPEDIA (ABILITANTE ALLA PROFESSIONE SANITARIA DI LOGOPEDISTA),13,1,12,0.077,0.923
2016/2017,8479,PODOLOGIA (ABILITANTE ALLA PROFESSIONE SANITARIA DI PODOLOGO),7,3,4,0.429,0.571
2016/2017,8481,IGIENE DENTALE (ABILITANTE ALLA PROFESSIONE SANITARIA DI IGIENISTA DENTALE),9,2,7,0.222,0.778
2016/2017,8482,TECNICHE DI NEUROFISIOPATOLOGIA (ABILITANTE ALLA PROFESSIONE SANITARIA DI TECNICO DI NEUROFISIOPATOLOGIA),9,2,7,0.222,0.778
2016/2017,8483,TECNICHE ORTOPEDICHE (ABILITANTE ALLA PROFESSIONE SANITARIA DI TECNICO ORTOPEDICO),12,6,6,0.5,0.5
2016/2017,8484,TECNICHE DI LABORATORIO BIOMEDICO (ABILITANTE ALLA PROFESSIONE SANITARIA DI TECNICO DI LABORATORIO BIOMEDICO),11,2,9,0.182,0.818
2016/2017,8485,"TECNICHE DI RADIOLOGIA MEDICA, PER IMMAGINI E RADIOTERAPIA (ABILITANTE ALLA PROFESSIONE SANITARIA DI TECNICO DI RADIOLOGIA MEDICA)",10,4,6,0.4,0.6
2016/2017,8486,"TECNICHE DI RADIOLOGIA MEDICA, PER IMMAGINI E RADIOTERAPIA (ABILITANTE ALLA PROFESSIONE SANITARIA DI TECNICO DI RADIOLOGIA MEDICA)",9,4,5,0.444,0.556
2016/2017,8487,TECNICHE DELLA PREVENZIONE NELL'AMBIENTE E NEI LUOGHI DI LAVORO (ABILITANTE  ALLA PROFESSIONE SANITARIA DI TECNICO DELLA PREVENZIONE NELL'AMBIENTE E NEI LUOGHI DI LAVORO),15,10,5,0.667,0.333
2016/2017,8488,SCIENZE INFERMIERISTICHE E OSTETRICHE,26,5,21,0.192,0.808
2016/2017,8491,SCIENZE CRIMINOLOGICHE PER L'INVESTIGAZIONE E LA SICUREZZA,107,23,84,0.215,0.785
2016/2017,8493,"ANTROPOLOGIA, RELIGIONI, CIVILTA' ORIENTALI",312,94,218,0.301,0.699
2016/2017,8495,SOCIOLOGIA,132,39,93,0.295,0.705
2016/2017,8512,SCIENZE DELLE ATTIVITA' MOTORIE E SPORTIVE,174,130,44,0.747,0.253
2016/2017,8513,CHIMICA INDUSTRIALE,102,61,41,0.598,0.402
2016/2017,8514,CHIMICA E TECNOLOGIE PER L'AMBIENTE E PER I MATERIALI,42,28,14,0.667,0.333
2016/2017,8515,CHIMICA E TECNOLOGIE PER L'AMBIENTE E PER I MATERIALI,28,19,9,0.679,0.321
2016/2017,8517,CONTROLLO DI QUALITA' DEI PRODOTTI PER LA SALUTE,11,2,9,0.182,0.818
2016/2017,8518,SCIENZE FARMACEUTICHE APPLICATE,55,7,48,0.127,0.873
2016/2017,8519,BIOTECNOLOGIE FARMACEUTICHE,49,23,26,0.469,0.531
2016/2017,8521,SICUREZZA E QUALITA' DELLE PRODUZIONI ANIMALI,44,16,28,0.364,0.636
2016/2017,8522,BIOTECNOLOGIE ANIMALI,29,11,18,0.379,0.621
2016/2017,8523,VERDE ORNAMENTALE E TUTELA DEL PAESAGGIO,44,22,22,0.5,0.5
2016/2017,8524,TECNOLOGIE AGRARIE,120,89,31,0.742,0.258
2016/2017,8525,SCIENZE DEL TERRITORIO E DELL'AMBIENTE AGRO-FORESTALE,57,37,20,0.649,0.351
2016/2017,8526,ECONOMIA E MARKETING NEL SISTEMA AGRO-INDUSTRIALE,81,51,30,0.63,0.37
2016/2017,8527,VITICOLTURA ED ENOLOGIA,54,38,16,0.704,0.296
2016/2017,8528,TECNOLOGIE ALIMENTARI,91,41,50,0.451,0.549
2016/2017,8531,SCIENZE E TECNOLOGIE ALIMENTARI,58,18,40,0.31,0.69
2016/2017,8532,"PROGETTAZIONE E GESTIONE DEGLI ECOSISTEMI AGRO-TERRITORIALI, FORESTALI E DEL PAESAGGIO",31,21,10,0.677,0.323
2016/2017,8537,SCIENCE FOR THE CONSERVATION - RESTORATION OF CULTURAL HERITAGE,20,5,15,0.25,0.75
2016/2017,8540,SCIENZE DELLA FORMAZIONE PRIMARIA,189,11,178,0.058,0.942
2016/2017,8609,TOURISM ECONOMICS AND MANAGEMENT / ECONOMIA E MANAGEMENT DEL TURISMO,55,19,36,0.345,0.655
2016/2017,8610,INGEGNERIA DELL'ENERGIA ELETTRICA,77,65,12,0.844,0.156
2016/2017,8611,INGEGNERIA DELL'ENERGIA ELETTRICA,34,33,1,0.971,0.029
2016/2017,8614,INGEGNERIA E SCIENZE INFORMATICHE,62,47,15,0.758,0.242
2016/2017,8615,INGEGNERIA E SCIENZE INFORMATICHE,180,153,27,0.85,0.15
2016/2017,8616,CONSERVAZIONE E RESTAURO DEI BENI CULTURALI (ABILITANTE AI SENSI DEL D. LGS N. 42/2004),9,0,9,0,1
2016/2017,8617,MEDICINA VETERINARIA,59,14,45,0.237,0.763
2016/2017,8626,FISICA DEL SISTEMA TERRA,17,13,4,0.765,0.235
2016/2017,8766,SCIENZE DELLE ATTIVITA' MOTORIE E SPORTIVE,96,68,28,0.708,0.292
2016/2017,8767,INGEGNERIA ELETTRONICA PER L'ENERGIA E L'INFORMAZIONE,35,31,4,0.886,0.114
2016/2017,8769,AEROSPACE ENGINEERING / INGEGNERIA AEROSPAZIALE,41,31,10,0.756,0.244
2016/2017,8770,INGEGNERIA ELETTRONICA E TELECOMUNICAZIONI PER L?ENERGIA,10,9,1,0.9,0.1
2016/2017,8771,INGEGNERIA MECCANICA,29,27,2,0.931,0.069
2016/2017,8772,CULTURE E TECNICHE DELLA MODA,234,29,205,0.124,0.876
2016/2017,8773,SCIENZE FILOSOFICHE,146,78,68,0.534,0.466
2016/2017,8774,SCIENZE E TECNICHE PSICOLOGICHE,217,56,161,0.258,0.742
2016/2017,8775,EDUCATORE NEI SERVIZI PER L'INFANZIA,224,4,220,0.018,0.982
2016/2017,8776,EDUCATORE SOCIALE E CULTURALE,198,35,163,0.177,0.823
2016/2017,8777,EDUCATORE SOCIALE E CULTURALE,122,20,102,0.164,0.836
2016/2017,8778,PROGETTAZIONE E GESTIONE DELL'INTERVENTO EDUCATIVO NEL DISAGIO SOCIALE,113,12,101,0.106,0.894
2016/2017,8779,PROGETTAZIONE E GESTIONE DELL'INTERVENTO EDUCATIVO NEL DISAGIO SOCIALE,35,2,33,0.057,0.943
2016/2017,8780,SCIENZE DELL?EDUCAZIONE PERMANENTE E DELLA FORMAZIONE CONTINUA,33,5,28,0.152,0.848
2016/2017,8782,RELAZIONI INTERNAZIONALI,130,51,79,0.392,0.608
2016/2017,8783,SCIENZE INTERNAZIONALI E DIPLOMATICHE,153,64,89,0.418,0.582
2016/2017,8784,"POLITICA, AMMINISTRAZIONE E ORGANIZZAZIONE",82,33,49,0.402,0.598
2016/2017,8786,SOCIOLOGIA E SERVIZIO SOCIALE,89,14,75,0.157,0.843
2016/2017,8829,INGEGNERIA DEI PROCESSI E DEI SISTEMI EDILIZI,60,29,31,0.483,0.517
2016/2017,8834,ACQUACOLTURA E IGIENE DELLE PRODUZIONI ITTICHE,63,32,31,0.508,0.492
2016/2017,8835,ECONOMICS AND FINANCE /ECONOMIA E FINANZA,87,57,30,0.655,0.345
2016/2017,8836,"BENI ARCHEOLOGICI, ARTISTICI E DEL PAESAGGIO: STORIA, TUTELA E VALORIZZAZIONE",43,7,36,0.163,0.837
2016/2017,8837,DISCIPLINE DELLA MUSICA E DEL TEATRO,62,20,42,0.323,0.677
2016/2017,8838,SCIENZE DEL LIBRO E DEL DOCUMENTO,20,3,17,0.15,0.85
2016/2017,8839,RESOURCE ECONOMICS AND SUSTAINABLE DEVELOPMENT / ECONOMIA DELLE RISORSE E DELLO SVILUPPO SOSTENIBILE,57,30,27,0.526,0.474
2016/2017,8840,COMUNICAZIONE PUBBLICA E D'IMPRESA,115,37,78,0.322,0.678
2016/2017,8842,AMMINISTRAZIONE E GESTIONE D'IMPRESA,92,46,46,0.5,0.5
2016/2017,8843,MANAGEMENT DELL?ECONOMIA SOCIALE,39,16,23,0.41,0.59
2016/2017,8845,SCIENZE STORICHE E ORIENTALISTICHE,203,127,76,0.626,0.374
2016/2017,8847,ECONOMIA DEL TURISMO,143,51,92,0.357,0.643
2016/2017,8848,ECONOMIA DELL'IMPRESA,146,77,69,0.527,0.473
2016/2017,8849,BENI CULTURALI,139,25,114,0.18,0.82
2016/2017,8850,LETTERE,677,211,466,0.312,0.688
2016/2017,8853,"SCIENZE POLITICHE, SOCIALI E INTERNAZIONALI",624,275,349,0.441,0.559
2016/2017,8854,QUANTITATIVE FINANCE,63,31,32,0.492,0.508
2016/2017,8855,ARCHEOLOGIA E CULTURE DEL MONDO ANTICO,65,20,45,0.308,0.692
2016/2017,8856,CHIMICA,54,20,34,0.37,0.63
2016/2017,8857,BIOLOGIA MARINA,31,11,20,0.355,0.645
2016/2017,8859,BIOTECNOLOGIE MEDICHE,45,11,34,0.244,0.756
2016/2017,8871,ECONOMIA AZIENDALE,198,123,75,0.621,0.379
2016/2017,8872,"FINANZA, ASSICURAZIONI E IMPRESA",47,34,13,0.723,0.277
2016/2017,8873,SCIENZE STATISTICHE,172,94,78,0.547,0.453
2016/2017,8874,"LANGUAGE, SOCIETY AND COMMUNICATION / LINGUA, SOCIETA E COMUNICAZIONE",126,20,106,0.159,0.841
2016/2017,8875,SCIENZE STATISTICHE,40,18,22,0.45,0.55
2016/2017,8876,"STATISTICA, ECONOMIA E IMPRESA",123,53,70,0.431,0.569
2016/2017,8877,"SCIENZE STATISTICHE, FINANZIARIE E ATTUARIALI",61,41,20,0.672,0.328
2016/2017,8878,SCIENZE DELLE PROFESSIONI SANITARIE DELLA PREVENZIONE,8,4,4,0.5,0.5
2016/2017,8879,ASSISTENZA SANITARIA (ABILITANTE ALLA PROFESSIONE SANITARIA DI ASSISTENTE SANITARIO),14,3,11,0.214,0.786
2016/2017,8880,HEALTH ECONOMICS AND MANAGEMENT / ECONOMIA SANITARIA E MANAGEMENT,47,14,33,0.298,0.702
2016/2017,8882,PRODUZIONI ANIMALI,76,31,45,0.408,0.592
2016/2017,8883,INTERNATIONAL HORTICULTURAL SCIENCE / ORTOFRUTTICOLTURA INTERNAZIONALE,36,21,15,0.583,0.417
2016/2017,8884,SCIENZE E TECNOLOGIE AGRARIE,130,92,38,0.708,0.292
2016/2017,8885,SCIENZE DELLA COMUNICAZIONE,554,197,357,0.356,0.644
2016/2017,8886,SEMIOTICA,61,22,39,0.361,0.639
2016/2017,8887,INGEGNERIA CHIMICA E BIOCHIMICA,130,59,71,0.454,0.546
2016/2017,8888,INGEGNERIA CIVILE,82,55,27,0.671,0.329
2016/2017,8889,"COOPERAZIONE INTERNAZIONALE, TUTELA DEI DIRITTI UMANI E DEI BENI ETNO-CULTURALI",92,20,72,0.217,0.783
2016/2017,8890,SVILUPPO E COOPERAZIONE INTERNAZIONALE,193,76,117,0.394,0.606
2016/2017,8891,AUTOMATION ENGINEERING / INGEGNERIA DELL?AUTOMAZIONE,62,54,8,0.871,0.129
2016/2017,8894,INGEGNERIA PER L'AMBIENTE E IL TERRITORIO,92,57,35,0.62,0.38
2016/2017,8895,CIVIL ENGINEERING,59,47,12,0.797,0.203
2016/2017,8896,INGEGNERIA CHIMICA E DI PROCESSO,83,51,32,0.614,0.386
2016/2017,8965,BUSINESS AND ECONOMICS/ECONOMIA E GESTIONE DI IMPRESA,151,62,89,0.411,0.589
2016/2017,9021,ADVANCED DESIGN,26,15,11,0.577,0.423
2016/2017,9022,FASHION CULTURE AND MANAGEMENT,34,3,31,0.088,0.912
2016/2017,9174,SPECIALIZED TRANSLATION,62,14,48,0.226,0.774
2016/2017,9198,INGEGNERIA PER L'AMBIENTE E IL TERRITORIO,74,44,30,0.595,0.405
2016/2017,9199,INGEGNERIA EDILE,31,16,15,0.516,0.484
2016/2017,9200,SVILUPPO LOCALE E GLOBALE,83,31,52,0.373,0.627
2016/2017,9201,OSTETRICIA (ABILITANTE ALLA PROFESSIONE SANITARIA DI OSTETRICA/O),19,0,19,0,1
2016/2017,9202,ECONOMIA E COMMERCIO,332,168,164,0.506,0.494
2016/2017,9203,ECONOMIA E MANAGEMENT,100,53,47,0.53,0.47
2016/2017,9205,TELECOMMUNICATIONS ENGINEERING,13,11,2,0.846,0.154
2016/2017,9206,PEDAGOGIA,121,13,108,0.107,0.893
2016/2017,9231,GIURISTA PER LE IMPRESE E PER LA PUBBLICA AMMINISTRAZIONE,1,1,0,1,0
2015/2016,0659,GIURISPRUDENZA,1091,365,726,0.335,0.665
2015/2016,0660,GIURISPRUDENZA,69,27,42,0.391,0.609
2015/2016,0881,ARCHITETTURA,84,32,52,0.381,0.619
2015/2016,0884,CHIMICA INDUSTRIALE,76,41,35,0.539,0.461
2015/2016,0897,DIREZIONE AZIENDALE,114,60,54,0.526,0.474
2015/2016,0899,ECONOMIA E DIRITTO,52,26,26,0.5,0.5
2015/2016,0900,ECONOMIA E PROFESSIONE,60,33,27,0.55,0.45
2015/2016,0901,"FINANZA, INTERMEDIARI E MERCATI",97,71,26,0.732,0.268
2015/2016,0902,INNOVATION AND ORGANIZATION OF CULTURE AND THE ARTS,29,8,21,0.276,0.724
2015/2016,0905,ECONOMIA E COMMERCIO,112,49,63,0.438,0.563
2015/2016,0915,CONSULENTE DEL LAVORO E DELLE RELAZIONI AZIENDALI,203,81,122,0.399,0.601
2015/2016,0916,GIURISTA D'IMPRESA E DELLE AMMINISTRAZIONI PUBBLICHE,44,22,22,0.5,0.5
2015/2016,0920,INGEGNERIA DELL'AUTOMAZIONE,150,141,9,0.94,0.06
2015/2016,0921,INGEGNERIA EDILE,25,18,7,0.72,0.28
2015/2016,0923,INGEGNERIA ELETTRONICA E TELECOMUNICAZIONI,103,90,13,0.874,0.126
2015/2016,0924,INGEGNERIA ENERGETICA,148,108,40,0.73,0.27
2015/2016,0925,INGEGNERIA GESTIONALE,245,154,91,0.629,0.371
2015/2016,0926,INGEGNERIA INFORMATICA,182,160,22,0.879,0.121
2015/2016,0927,INGEGNERIA MECCANICA,183,167,16,0.913,0.087
2015/2016,0928,INGEGNERIA PER L'AMBIENTE E IL TERRITORIO,78,38,40,0.487,0.513
2015/2016,0930,INGEGNERIA CIVILE,171,113,58,0.661,0.339
2015/2016,0934,INGEGNERIA ELETTRONICA,44,33,11,0.75,0.25
2015/2016,0935,INGEGNERIA ENERGETICA,120,85,35,0.708,0.292
2015/2016,0936,INGEGNERIA GESTIONALE,178,102,76,0.573,0.427
2015/2016,0937,INGEGNERIA INFORMATICA,66,62,4,0.939,0.061
2015/2016,0938,INGEGNERIA MECCANICA,149,138,11,0.926,0.074
2015/2016,0940,INGEGNERIA EDILE - ARCHITETTURA,76,21,55,0.276,0.724
2015/2016,0946,INGEGNERIA BIOMEDICA,118,67,51,0.568,0.432
2015/2016,0949,INGEGNERIA MECCANICA,99,95,4,0.96,0.04
2015/2016,0956,"DAMS - DISCIPLINE DELLE ARTI, DELLA MUSICA  E DELLO SPETTACOLO",570,237,333,0.416,0.584
2015/2016,0957,FILOSOFIA,256,130,126,0.508,0.492
2015/2016,0962,STORIA,212,143,69,0.675,0.325
2015/2016,0964,ANTROPOLOGIA CULTURALE ED ETNOLOGIA,84,31,53,0.369,0.631
2015/2016,0966,"CINEMA, TELEVISIONE E PRODUZIONE MULTIMEDIALE",116,48,68,0.414,0.586
2015/2016,0970,"FILOLOGIA, LETTERATURA E TRADIZIONE CLASSICA",74,23,51,0.311,0.689
2015/2016,0971,GEOGRAFIA E PROCESSI TERRITORIALI,18,12,6,0.667,0.333
2015/2016,0973,"ITALIANISTICA, CULTURE LETTERARIE EUROPEE, SCIENZE LINGUISTICHE",323,116,207,0.359,0.641
2015/2016,0977,ARTI VISIVE,162,30,132,0.185,0.815
2015/2016,0979,LINGUE E LETTERATURE STRANIERE,382,64,318,0.168,0.832
2015/2016,0980,"LINGUE, MERCATI E CULTURE DELL'ASIA",108,39,69,0.361,0.639
2015/2016,0981,"LETTERATURE MODERNE, COMPARATE E POSTCOLONIALI",102,16,86,0.157,0.843
2015/2016,0983,LINGUA E CULTURA ITALIANE PER STRANIERI,121,17,104,0.14,0.86
2015/2016,0989,NEUROSCIENZE E RIABILITAZIONE NEUROPSICOLOGICA,41,5,36,0.122,0.878
2015/2016,0990,PSICOLOGIA CLINICA,85,18,67,0.212,0.788
2015/2016,0991,PSICOLOGIA COGNITIVA APPLICATA,34,7,27,0.206,0.794
2015/2016,0992,PSICOLOGIA DELLE ORGANIZZAZIONI E DEI SERVIZI,26,11,15,0.423,0.577
2015/2016,0993,PSICOLOGIA SCOLASTICA E DI COMUNITA',37,7,30,0.189,0.811
2015/2016,8004,ASTRONOMIA,105,57,48,0.543,0.457
2015/2016,8005,BIOTECNOLOGIE,79,36,43,0.456,0.544
2015/2016,8006,CHIMICA E CHIMICA DEI MATERIALI,116,70,46,0.603,0.397
2015/2016,8007,FISICA,226,171,55,0.757,0.243
2015/2016,8009,INFORMATICA,125,113,12,0.904,0.096
2015/2016,8010,MATEMATICA,154,83,71,0.539,0.461
2015/2016,8011,SCIENZE AMBIENTALI,71,34,37,0.479,0.521
2015/2016,8012,SCIENZE BIOLOGICHE,166,58,108,0.349,0.651
2015/2016,8014,INFORMATICA PER IL MANAGEMENT,77,50,27,0.649,0.351
2015/2016,8015,SCIENZE GEOLOGICHE,35,27,8,0.771,0.229
2015/2016,8016,SCIENZE NATURALI,49,25,24,0.51,0.49
2015/2016,8018,ASTROFISICA E COSMOLOGIA,21,15,6,0.714,0.286
2015/2016,8020,BIOINFORMATICS,19,13,6,0.684,0.316
2015/2016,8021,BIOLOGIA MOLECOLARE E CELLULARE,33,9,24,0.273,0.727
2015/2016,8022,BIOTECNOLOGIE MOLECOLARI E INDUSTRIALI,24,9,15,0.375,0.625
2015/2016,8023,BIOLOGIA DELLA SALUTE,65,15,50,0.231,0.769
2015/2016,8025,FISICA,69,47,22,0.681,0.319
2015/2016,8026,FOTOCHIMICA E MATERIALI MOLECOLARI,30,15,15,0.5,0.5
2015/2016,8027,GEOLOGIA E TERRITORIO,44,23,21,0.523,0.477
2015/2016,8028,INFORMATICA,57,50,7,0.877,0.123
2015/2016,8036,SCIENZE E TECNICHE DELL'ATTIVITA' MOTORIA PREVENTIVA E ADATTATA,73,36,37,0.493,0.507
2015/2016,8037,SCIENZE E TECNICHE DELL'ATTIVITA' SPORTIVA,58,51,7,0.879,0.121
2015/2016,8038,"ECONOMIA, MERCATI E ISTITUZIONI",165,106,59,0.642,0.358
2015/2016,8040,SERVIZIO SOCIALE,97,13,84,0.134,0.866
2015/2016,8048,SCIENZE INTERNAZIONALI E DIPLOMATICHE,414,138,276,0.333,0.667
2015/2016,8049,INTERDISCIPLINARY RESEARCH AND STUDIES ON EASTERN EUROPE,40,18,22,0.45,0.55
2015/2016,8051,MASS MEDIA E POLITICA,31,12,19,0.387,0.613
2015/2016,8059,MEDIAZIONE LINGUISTICA INTERCULTURALE,165,35,130,0.212,0.788
2015/2016,8060,INTERPRETAZIONE,30,10,20,0.333,0.667
2015/2016,8061,TRADUZIONE SPECIALIZZATA,62,12,50,0.194,0.806
2015/2016,8182,DESIGN DEL PRODOTTO INDUSTRIALE,79,43,36,0.544,0.456
2015/2016,8198,INGEGNERIA BIOMEDICA,51,19,32,0.373,0.627
2015/2016,8204,ODONTOIATRIA E PROTESI DENTARIA,21,12,9,0.571,0.429
2015/2016,8208,MATEMATICA,89,33,56,0.371,0.629
2015/2016,8209,SCIENZE E GESTIONE DELLA NATURA,34,17,17,0.5,0.5
2015/2016,8210,MANAGEMENT DELLE ATTIVITA' MOTORIE E SPORTIVE,26,23,3,0.885,0.115
2015/2016,8263,INGEGNERIA AEROSPAZIALE,96,82,14,0.854,0.146
2015/2016,8406,MANAGEMENT E MARKETING,145,97,48,0.669,0.331
2015/2016,8408,ECONOMICS,25,19,6,0.76,0.24
2015/2016,8412,CHIMICA E TECNOLOGIA FARMACEUTICHE,120,31,89,0.258,0.742
2015/2016,8413,FARMACIA,133,32,101,0.241,0.759
2015/2016,8414,FARMACIA,57,7,50,0.123,0.877
2015/2016,8415,MEDICINA E CHIRURGIA,297,149,148,0.502,0.498
2015/2016,8418,ANALISI E GESTIONE DELL'AMBIENTE,37,22,15,0.595,0.405
2015/2016,8419,BIODIVERSITA' ED EVOLUZIONE,42,17,25,0.405,0.595
2015/2016,8420,ECONOMIA E POLITICA ECONOMICA,66,32,34,0.485,0.515
2015/2016,8470,DIETISTICA (ABILITANTE ALLA PROFESSIONE SANITARIA DI DIETISTA),9,4,5,0.444,0.556
2015/2016,8471,OSTETRICIA (ABILITANTE ALLA PROFESSIONE SANITARIA DI OSTETRICA/O),26,0,26,0,1
2015/2016,8473,INFERMIERISTICA (ABILITANTE ALLA PROFESSIONE SANITARIA DI INFERMIERE),237,58,179,0.245,0.755
2015/2016,8474,INFERMIERISTICA (ABILITANTE ALLA PROFESSIONE SANITARIA DI INFERMIERE),120,30,90,0.25,0.75
2015/2016,8475,INFERMIERISTICA (ABILITANTE ALLA PROFESSIONE SANITARIA DI INFERMIERE),163,32,131,0.196,0.804
2015/2016,8476,FISIOTERAPIA (ABILITANTE ALLA PROFESSIONE SANITARIA DI FISIOTERAPISTA),28,20,8,0.714,0.286
2015/2016,8477,EDUCAZIONE PROFESSIONALE (ABILITANTE ALLA PROFESSIONE SANITARIA DI EDUCATORE PROFESSIONALE),29,3,26,0.103,0.897
2015/2016,8478,LOGOPEDIA (ABILITANTE ALLA PROFESSIONE SANITARIA DI LOGOPEDISTA),6,0,6,0,1
2015/2016,8479,PODOLOGIA (ABILITANTE ALLA PROFESSIONE SANITARIA DI PODOLOGO),6,2,4,0.333,0.667
2015/2016,8481,IGIENE DENTALE (ABILITANTE ALLA PROFESSIONE SANITARIA DI IGIENISTA DENTALE),10,1,9,0.1,0.9
2015/2016,8482,TECNICHE DI NEUROFISIOPATOLOGIA (ABILITANTE ALLA PROFESSIONE SANITARIA DI TECNICO DI NEUROFISIOPATOLOGIA),7,0,7,0,1
2015/2016,8483,TECNICHE ORTOPEDICHE (ABILITANTE ALLA PROFESSIONE SANITARIA DI TECNICO ORTOPEDICO),8,6,2,0.75,0.25
2015/2016,8484,TECNICHE DI LABORATORIO BIOMEDICO (ABILITANTE ALLA PROFESSIONE SANITARIA DI TECNICO DI LABORATORIO BIOMEDICO),15,2,13,0.133,0.867
2015/2016,8485,"TECNICHE DI RADIOLOGIA MEDICA, PER IMMAGINI E RADIOTERAPIA (ABILITANTE ALLA PROFESSIONE SANITARIA DI TECNICO DI RADIOLOGIA MEDICA)",10,7,3,0.7,0.3
2015/2016,8486,"TECNICHE DI RADIOLOGIA MEDICA, PER IMMAGINI E RADIOTERAPIA (ABILITANTE ALLA PROFESSIONE SANITARIA DI TECNICO DI RADIOLOGIA MEDICA)",9,4,5,0.444,0.556
2015/2016,8487,TECNICHE DELLA PREVENZIONE NELL'AMBIENTE E NEI LUOGHI DI LAVORO (ABILITANTE  ALLA PROFESSIONE SANITARIA DI TECNICO DELLA PREVENZIONE NELL'AMBIENTE E NEI LUOGHI DI LAVORO),22,11,11,0.5,0.5
2015/2016,8488,SCIENZE INFERMIERISTICHE E OSTETRICHE,25,4,21,0.16,0.84
2015/2016,8491,SCIENZE CRIMINOLOGICHE PER L'INVESTIGAZIONE E LA SICUREZZA,118,26,92,0.22,0.78
2015/2016,8493,"ANTROPOLOGIA, RELIGIONI, CIVILTA' ORIENTALI",315,113,202,0.359,0.641
2015/2016,8495,SOCIOLOGIA,161,51,110,0.317,0.683
2015/2016,8512,SCIENZE DELLE ATTIVITA' MOTORIE E SPORTIVE,181,131,50,0.724,0.276
2015/2016,8513,CHIMICA INDUSTRIALE,107,76,31,0.71,0.29
2015/2016,8514,CHIMICA E TECNOLOGIE PER L'AMBIENTE E PER I MATERIALI,33,25,8,0.758,0.242
2015/2016,8515,CHIMICA E TECNOLOGIE PER L'AMBIENTE E PER I MATERIALI,22,13,9,0.591,0.409
2015/2016,8517,CONTROLLO DI QUALITA' DEI PRODOTTI PER LA SALUTE,4,1,3,0.25,0.75
2015/2016,8518,SCIENZE FARMACEUTICHE APPLICATE,54,5,49,0.093,0.907
2015/2016,8519,BIOTECNOLOGIE FARMACEUTICHE,19,7,12,0.368,0.632
2015/2016,8521,SICUREZZA E QUALITA' DELLE PRODUZIONI ANIMALI,38,14,24,0.368,0.632
2015/2016,8522,BIOTECNOLOGIE ANIMALI,30,10,20,0.333,0.667
2015/2016,8523,VERDE ORNAMENTALE E TUTELA DEL PAESAGGIO,52,31,21,0.596,0.404
2015/2016,8524,TECNOLOGIE AGRARIE,122,91,31,0.746,0.254
2015/2016,8525,SCIENZE DEL TERRITORIO E DELL'AMBIENTE AGRO-FORESTALE,62,40,22,0.645,0.355
2015/2016,8526,ECONOMIA E MARKETING NEL SISTEMA AGRO-INDUSTRIALE,75,51,24,0.68,0.32
2015/2016,8527,VITICOLTURA ED ENOLOGIA,36,24,12,0.667,0.333
2015/2016,8528,TECNOLOGIE ALIMENTARI,76,33,43,0.434,0.566
2015/2016,8531,SCIENZE E TECNOLOGIE ALIMENTARI,58,24,34,0.414,0.586
2015/2016,8532,"PROGETTAZIONE E GESTIONE DEGLI ECOSISTEMI AGRO-TERRITORIALI, FORESTALI E DEL PAESAGGIO",25,16,9,0.64,0.36
2015/2016,8537,SCIENCE FOR THE CONSERVATION - RESTORATION OF CULTURAL HERITAGE,16,7,9,0.438,0.563
2015/2016,8540,SCIENZE DELLA FORMAZIONE PRIMARIA,208,13,195,0.063,0.938
2015/2016,8609,TOURISM ECONOMICS AND MANAGEMENT / ECONOMIA E MANAGEMENT DEL TURISMO,50,17,33,0.34,0.66
2015/2016,8610,INGEGNERIA DELL'ENERGIA ELETTRICA,94,84,10,0.894,0.106
2015/2016,8611,INGEGNERIA DELL'ENERGIA ELETTRICA,47,39,8,0.83,0.17
2015/2016,8614,INGEGNERIA E SCIENZE INFORMATICHE,66,55,11,0.833,0.167
2015/2016,8615,INGEGNERIA E SCIENZE INFORMATICHE,165,137,28,0.83,0.17
2015/2016,8616,CONSERVAZIONE E RESTAURO DEI BENI CULTURALI (ABILITANTE AI SENSI DEL D. LGS N. 42/2004),10,1,9,0.1,0.9
2015/2016,8617,MEDICINA VETERINARIA,57,12,45,0.211,0.789
2015/2016,8626,FISICA DEL SISTEMA TERRA,11,8,3,0.727,0.273
2015/2016,8766,SCIENZE DELLE ATTIVITA' MOTORIE E SPORTIVE,95,70,25,0.737,0.263
2015/2016,8767,INGEGNERIA ELETTRONICA PER L'ENERGIA E L'INFORMAZIONE,28,25,3,0.893,0.107
2015/2016,8769,AEROSPACE ENGINEERING / INGEGNERIA AEROSPAZIALE,38,31,7,0.816,0.184
2015/2016,8770,INGEGNERIA ELETTRONICA E TELECOMUNICAZIONI PER L?ENERGIA,15,13,2,0.867,0.133
2015/2016,8771,INGEGNERIA MECCANICA,33,32,1,0.97,0.03
2015/2016,8772,CULTURE E TECNICHE DELLA MODA,222,23,199,0.104,0.896
2015/2016,8773,SCIENZE FILOSOFICHE,123,57,66,0.463,0.537
2015/2016,8774,SCIENZE E TECNICHE PSICOLOGICHE,241,62,179,0.257,0.743
2015/2016,8775,EDUCATORE NEI SERVIZI PER L'INFANZIA,167,11,156,0.066,0.934
2015/2016,8776,EDUCATORE SOCIALE E CULTURALE,171,29,142,0.17,0.83
2015/2016,8777,EDUCATORE SOCIALE E CULTURALE,122,18,104,0.148,0.852
2015/2016,8778,PROGETTAZIONE E GESTIONE DELL'INTERVENTO EDUCATIVO NEL DISAGIO SOCIALE,86,9,77,0.105,0.895
2015/2016,8779,PROGETTAZIONE E GESTIONE DELL'INTERVENTO EDUCATIVO NEL DISAGIO SOCIALE,24,2,22,0.083,0.917
2015/2016,8780,SCIENZE DELL?EDUCAZIONE PERMANENTE E DELLA FORMAZIONE CONTINUA,25,6,19,0.24,0.76
2015/2016,8781,PEDAGOGIA,95,12,83,0.126,0.874
2015/2016,8782,RELAZIONI INTERNAZIONALI,105,44,61,0.419,0.581
2015/2016,8783,SCIENZE INTERNAZIONALI E DIPLOMATICHE,101,31,70,0.307,0.693
2015/2016,8784,"POLITICA, AMMINISTRAZIONE E ORGANIZZAZIONE",89,40,49,0.449,0.551
2015/2016,8785,SVILUPPO LOCALE E GLOBALE,66,26,40,0.394,0.606
2015/2016,8786,SOCIOLOGIA E SERVIZIO SOCIALE,78,19,59,0.244,0.756
2015/2016,8829,INGEGNERIA DEI PROCESSI E DEI SISTEMI EDILIZI,63,34,29,0.54,0.46
2015/2016,8834,ACQUACOLTURA E IGIENE DELLE PRODUZIONI ITTICHE,39,29,10,0.744,0.256
2015/2016,8835,ECONOMICS AND FINANCE /ECONOMIA E FINANZA,96,66,30,0.688,0.313
2015/2016,8836,"BENI ARCHEOLOGICI, ARTISTICI E DEL PAESAGGIO: STORIA, TUTELA E VALORIZZAZIONE",54,19,35,0.352,0.648
2015/2016,8837,DISCIPLINE DELLA MUSICA E DEL TEATRO,51,15,36,0.294,0.706
2015/2016,8838,SCIENZE DEL LIBRO E DEL DOCUMENTO,27,4,23,0.148,0.852
2015/2016,8839,RESOURCE ECONOMICS AND SUSTAINABLE DEVELOPMENT / ECONOMIA DELLE RISORSE E DELLO SVILUPPO SOSTENIBILE,38,17,21,0.447,0.553
2015/2016,8840,COMUNICAZIONE PUBBLICA E D'IMPRESA,119,30,89,0.252,0.748
2015/2016,8841,FASHION CULTURE AND MANAGEMENT / CULTURA E MANAGEMENT DELLA MODA,48,10,38,0.208,0.792
2015/2016,8842,AMMINISTRAZIONE E GESTIONE D'IMPRESA,109,58,51,0.532,0.468
2015/2016,8843,MANAGEMENT DELL?ECONOMIA SOCIALE,41,14,27,0.341,0.659
2015/2016,8845,SCIENZE STORICHE E ORIENTALISTICHE,187,123,64,0.658,0.342
2015/2016,8846,TELECOMMUNICATIONS ENGINEERING / INGEGNERIA DELLE TELECOMUNICAZIONI,27,24,3,0.889,0.111
2015/2016,8847,ECONOMIA DEL TURISMO,114,40,74,0.351,0.649
2015/2016,8848,ECONOMIA DELL'IMPRESA,141,73,68,0.518,0.482
2015/2016,8849,BENI CULTURALI,143,30,113,0.21,0.79
2015/2016,8850,LETTERE,588,159,429,0.27,0.73
2015/2016,8851,ECONOMIA E COMMERCIO,287,130,157,0.453,0.547
2015/2016,8853,"SCIENZE POLITICHE, SOCIALI E INTERNAZIONALI",557,232,325,0.417,0.583
2015/2016,8854,QUANTITATIVE FINANCE,52,35,17,0.673,0.327
2015/2016,8855,ARCHEOLOGIA E CULTURE DEL MONDO ANTICO,70,18,52,0.257,0.743
2015/2016,8856,CHIMICA,58,29,29,0.5,0.5
2015/2016,8857,BIOLOGIA MARINA,31,13,18,0.419,0.581
2015/2016,8858,ECONOMIA E GESTIONE AZIENDALE,77,34,43,0.442,0.558
2015/2016,8859,BIOTECNOLOGIE MEDICHE,42,7,35,0.167,0.833
2015/2016,8871,ECONOMIA AZIENDALE,194,124,70,0.639,0.361
2015/2016,8872,"FINANZA, ASSICURAZIONI E IMPRESA",42,26,16,0.619,0.381
2015/2016,8873,SCIENZE STATISTICHE,132,65,67,0.492,0.508
2015/2016,8874,"LANGUAGE, SOCIETY AND COMMUNICATION / LINGUA, SOCIETA E COMUNICAZIONE",128,16,112,0.125,0.875
2015/2016,8875,SCIENZE STATISTICHE,35,13,22,0.371,0.629
2015/2016,8876,"STATISTICA, ECONOMIA E IMPRESA",123,65,58,0.528,0.472
2015/2016,8877,"SCIENZE STATISTICHE, FINANZIARIE E ATTUARIALI",43,26,17,0.605,0.395
2015/2016,8878,SCIENZE DELLE PROFESSIONI SANITARIE DELLA PREVENZIONE,15,4,11,0.267,0.733
2015/2016,8879,ASSISTENZA SANITARIA (ABILITANTE ALLA PROFESSIONE SANITARIA DI ASSISTENTE SANITARIO),11,1,10,0.091,0.909
2015/2016,8880,HEALTH ECONOMICS AND MANAGEMENT / ECONOMIA SANITARIA E MANAGEMENT,30,11,19,0.367,0.633
2015/2016,8882,PRODUZIONI ANIMALI,81,38,43,0.469,0.531
2015/2016,8883,INTERNATIONAL HORTICULTURAL SCIENCE / ORTOFRUTTICOLTURA INTERNAZIONALE,30,21,9,0.7,0.3
2015/2016,8884,SCIENZE E TECNOLOGIE AGRARIE,109,79,30,0.725,0.275
2015/2016,8885,SCIENZE DELLA COMUNICAZIONE,476,164,312,0.345,0.655
2015/2016,8886,SEMIOTICA,58,20,38,0.345,0.655
2015/2016,8887,INGEGNERIA CHIMICA E BIOCHIMICA,132,72,60,0.545,0.455
2015/2016,8888,INGEGNERIA CIVILE,105,69,36,0.657,0.343
2015/2016,8889,"COOPERAZIONE INTERNAZIONALE, TUTELA DEI DIRITTI UMANI E DEI BENI ETNO-CULTURALI",100,24,76,0.24,0.76
2015/2016,8890,SVILUPPO E COOPERAZIONE INTERNAZIONALE,130,49,81,0.377,0.623
2015/2016,8891,AUTOMATION ENGINEERING / INGEGNERIA DELL?AUTOMAZIONE,59,50,9,0.847,0.153
2015/2016,8894,INGEGNERIA PER L'AMBIENTE E IL TERRITORIO,85,52,33,0.612,0.388
2015/2016,8895,CIVIL ENGINEERING,60,47,13,0.783,0.217
2015/2016,8896,INGEGNERIA CHIMICA E DI PROCESSO,87,53,34,0.609,0.391
2015/2016,8965,BUSINESS AND ECONOMICS/ECONOMIA E GESTIONE DI IMPRESA,148,75,73,0.507,0.493
